hhhhhhhhhhhhhhhhhhhhhhhhhhhhhhhhhhhhhhhhhhhhhhhhhhhh
HhhhHhhhHhhhHhhhHhhhHhhhHhhhHhhhHhhhHhhhHhhhHhhhHhhh
vv  .  .   vv .  .  . vv  . vv  .  .  .  .  .  *  vv
vv  .  .   vv         vv    vv                    vv
vv  .  .   vv .  .  . vv  . vv  .  .  .  .  .  .  vv
Vv  .  .   Vv         Vv    Vv                    Vv
vv            .  vv . vv  .        .  .  .  .  .  vv
vv  .  .         vv   vv          hhhhhhhhhhhhhhhhvv
vv            .  vv . vv  .       HhhhHhhhHhhhHhhhvv
Vv  .  .         Vv   Vv      .  .  .  .  .  .  . Vv
vv         vv .  vv .  .  . vv                    vv
vv  .  .   vv    vv         vv.  .  .  .  .     . vv
vv         vv    vv         vv               K    vv
Vv  .  .   Vv .  Vv .  .  . Vv.  .  .  .  .     . Vv
hhhhhhhhhhhhhhhhhhhhhhhhhhhhhhhhhhhhhhhh    hhhhhhhh
HhhhHhhhHhhhHhhhHhhhHhhhHhhhHhhhHhhhHhhh    HhhhHhhh
  vv .  . hhhh.  .  .  .  .  .  .  .hhhh  .  .  vv  
  vv      Hhhh                      Hhhh        vv  
  vv .  .  .  .  .  .  .  .  .  .  .  .  .  .  .vv  
  Vv                                            Vv   
hhhh .  .  .  .  .  . hhhh   K  .  .  .  .  .   hhhh
Hhhh                  Hhhh                      Hhhh
vv   .  . hhhhhhhhhhhhhhhhhhhhhhhhhhhhhhhhhhhhhhhhvv
vv        HhhhHhhhHhhhHhhhHhhhHhhhHhhhHhhhHhhhHhhhvv
vv   .  .  .  .  .  .  .  .  .  .  .  .  .  .  .  vv
Vv                                                Vv
vv   K  .  .  .  .  .  .  .  .  .  .  .  .  .  .  vv
vv                                                vv
vv        hhhhhhhhhhhh    hhhh    hhhhhhhhhhhh    vv
Vv        HhhhHhhhHhhh    Hhhh    HhhhHhhhHhhh    Vv
vv        hhhh            hhhh    hhhh    hhhh    vv
vv        Hhhh            Hhhh    HhhhhhhhHhhh    vv
vv        hhhhhhhh        hhhh    hhhhHhhhhhhh    vv
Vv        HhhhHhhh        Hhhh    Hhhh    Hhhh    Vv
vv        hhhh            hhhh    hhhhhhhhhhhh    vv
vv        Hhhh            Hhhh    HhhhHhhhHhhh    vv
vv                                                vv
Vv    K .  .  .  .  .  .  .  .  .  .  .  .  .  K  Vv
vv                                                vv
vv   .  .  .  .  .  .  .  .  .  .  .  .  .  .  .  vv
vv      hhhhhhhhhhhhhhhh    hhhhhhhhhhhhhhhh      vv
Vv      HhhhHhhhHhhhHhhh    HhhhHhhhHhhhHhhh      Vv
vv   .  .  .  .  .  .  .  .  .  .  .  .  .  .  .  vv
vv                       +                        vv
vv      .  .  .  .  .  . Xx  .  .  .  .  .  .  .  vv
Vv                                                Vv
hhhh              vvhhhh    hhhhvv              hhhh
Hhhh    hhhh      vvHhhh####Hhhhvv     hhhh     Hhhh
hhhh    Hhhh      vv############vv     Hhhh     hhhh
Hhhh              Vv##B######O##Vv              Hhhh
vv  .  .  .  .  . vv############vv  .  .  .  .  . vv
vv                vv############vv                vv
vv  K  .  .  .  . vv############vv  .  .  .  .  K vv
Vv                Vv##P######R##Vv                Vv
vv  .  .  . vv  . vv############vv  .  vv .  .  . vv
vv          vv    vv############vv     vv         vv
vv  *  .  . vv  . vvhhhhhhhhhhhhvv  .  vv .  . *  vv
Vv          Vv    VvHhhhHhhhHhhhVv     Vv         Vv
hhhhhhhhhhhhhhhhhhhhhhhhhhhhhhhhhhhhhhhhhhhhhhhhhhhh
HhhhHhhhHhhhHhhhHhhhHhhhHhhhHhhhHhhhHhhhHhhhHhhhHhhh