hhhhhhhhhhhhhhhhhhhhhhhhhhhhhhhhhhhhhhhhhhhhhhhhhhhh
HhhhHhhhHhhhHhhhHhhhHhhhHhhhHhhhHhhhHhhhHhhhHhhhHhhh
vv     vv                vv                vv     vv
vv     vv                vv                vv     vv
vv  *  vv . . . . . . .  vv  . . . . . . . vv  *  vv
Vv     Vv                Vv                Vv     Vv
vv  .  vv                vv                vv  .  vv
vv     vv                vv                vv     vv
vv  .  vv . . . . . . .  vv  . . . . . . . vv  .  vv
Vv     Vv                Vv                Vv     Vv
vv  .  hhhh .         .  vv  .         . hhhh  .  vv
vv     Hhhh    hhhh      vv      hhhh    Hhhh     vv
vv  .  hhhh .  Hhhh  . . vv . .  Hhhh  . hhhh  .  vv
Vv     Hhhh              Vv              Hhhh     Vv
vv          .         .  vv  .         .          vv
vv      . .   . . . .    vv    . . . .   . .      vv
vv  K       .         .  vv  .         .       K  vv
Vv    .        .         Vv         .        .    Vv
hhhh      hhhhhhhhhhhhhhhhhhhhhhhhhhhhhhhh      hhhh
Hhhh  .   HhhhHhhhHhhhHhhhHhhhHhhhHhhhHhhh   .  Hhhh
  vv      vv                            vv      vv  
  vv  .   vv    .                  .    vv   .  vv  
  vv      vv                            vv      vv  
  Vv  .   Vv    . . . . .  . . . . .    Vv   .  Vv   
hhhh      vv                            vv      hhhh
Hhhh  .   vv    .        Xx        .    vv   .  Hhhh
vv        vv                            vv        vv
vv    .   Vv   .  vvhhhh    hhhhvv  .   Vv   .    vv
vv   .   .   .    vvHhhh####Hhhhvv    .   .   .   vv
Vv             .  vv############vv  .             Vv
vv   .            Vv############Vv             K  vv
vv             .  vv##B######O##vv  .             vv
vv   .            vv############vv            .   vv
Vv        vv   .  vv############vv  .   vv        Vv
vv   .    vv      Vv##P######R##Vv      vv    .   vv
vv        vv   .  vv############vv  .   vv        vv
vv   .    Vv      vv############vv      Vv    .   vv
Vv        vv   .  vvhhhhhhhhhhhhvv  .   vv        Vv
vv   .    vv      VvHhhhHhhhHhhhVv      vv    .   vv
vv        vv   .                    .   vv        vv
vv .      Vv                            Vv      . vv
Vv    hhhhhhhh . . . . .    . . . . . hhhhhhhh    Vv
vv .  HhhhHhhh                        HhhhHhhh  . vv
vv             .    hhhh    hhhh    .             vv
vv   .   .   .      Hhhh    Hhhh      .   .   .   vv
Vv             .    hhhhhhhhhhhh    .             Vv
vv  K        .      HhhhHhhhHhhh      .         . vv
vv             .   hhhh      hhhh   .             vv
vv .   .   .       Hhhh      Hhhh       .   .   . vv
Vv             .   vv     +    vv   .             Vv
hhhhhhhhhhhh       vv          vv       hhhhhhhhhhhh
HhhhHhhhHhhh  .    vv          vv    .  HhhhHhhhHhhh
hhhh             . Vv          Vv .             hhhh
Hhhh               vv          vv               Hhhh
vv    .   .   .    vv          vv    .   .   .    vv
vv     .           vv          vv           .     vv
vv     .           Vv          Vv           .     vv
Vv         hhhhhhhhhhhh      hhhhhhhhhhhh         Vv
vv     .   HhhhHhhhHhhh      HhhhHhhhHhhh   .     vv
vv     .                                    .     vv
vv  * . . . . . . . . . .  . . . . . . . . . . *  vv
Vv                                                Vv
hhhhhhhhhhhhhhhhhhhhhhhhhhhhhhhhhhhhhhhhhhhhhhhhhhhh
HhhhHhhhHhhhHhhhHhhhHhhhHhhhHhhhHhhhHhhhHhhhHhhhHhhh