hhhhhhhhhhhhhhhhhhhhhhhhhhhhhhhhhhhhhhhhhhhhhhhhhhhh
HhhhHhhhHhhhHhhhHhhhHhhhHhhhHhhhHhhhHhhhHhhhHhhhHhhh
vv                       vv                       vv
vv                       vv                       vv
vv  * . . . . . . . . .  vv  . . . . . . . . . *  vv
Vv                       Vv                       Vv
vv  .       .         .      .         .          vv
vv     hhhh    hhhh              hhhh    hhhh     vv
vv  .  Hhhh .  Hhhh  . .    . .  Hhhh  . Hhhh  .  vv
Vv                                                Vv
vv  .       .         .  vv  .         .       .  vv
vv    . . .   . . . .    vv    . . . .   . . .    vv
vv  .       .         .  vv  .         .       .  vv
Vv    .        .         Vv         .        .    Vv
hhhh     hhhh     hhhhhhhhhhhhhhhh     hhhh     hhhh
Hhhh  .  Hhhh  .  HhhhHhhhHhhhHhhh  .  Hhhh  .  Hhhh
  vv     hhhh                          hhhh     vv  
  vv  .  hhhh  .                    .  hhhh  .  vv  
  vv     hhhh                          hhhh     vv  
  Vv  .  Hhhh  * . . . .    . . . . .  Hhhh  .  Vv   
hhhh     hhhh                          hhhh     hhhh
Hhhh  .  Hhhh  .         Xx         .  Hhhh  .  Hhhh
vv                                                vv
vv             .  vvhhhh    hhhhvv  .             vv
vv . . . . . .    vvHhhh####Hhhhvv    . . . . . . vv
Vv             .  vv############vv  .             Vv
vv                Vv############Vv                vv
vv             .  vv##B######O##vv  .             vv
vv                vv############vv                vv
Vv             .  vv############vv  .             Vv
vv                Vv##P######R##Vv                vv
vv             .  vv############vv  .             vv
vv                vv############vv                vv
Vv        hhhh .  vvhhhhhhhhhhhhvv  . hhhh        Vv
vv        Hhhh    VvHhhhHhhhHhhhVv    Hhhh        vv
vv        hhhh .                    . hhhh        vv
vv        Hhhh                        Hhhh        vv
Vv    hhhhhhhh . . . . .    . . . . . hhhhhhhh    Vv
vv    HhhhHhhh                        HhhhHhhh    vv
vv                  hhhh    hhhh                  vv
vv                  Hhhh    Hhhh                  vv
Vv                  hhhhhhhhhhhh                  Vv
vv                  HhhhHhhhHhhh                  vv
vv                 hhhh      hhhh                 vv
vv                 Hhhh      Hhhh                 vv
Vv                                                Vv
hhhh                         +                  hhhh
Hhhh                                            Hhhh
hhhh                      .                     hhhh
Hhhh                                            Hhhh
vv                                                vv
vv                                                vv
vv         hhhhhhhhhhhh      hhhhhhhhhhhh         vv
Vv         HhhhHhhhHhhh      HhhhHhhhHhhh         Vv
vv                                                vv
vv                                                vv
vv                                                vv
Vv                                                Vv
hhhhhhhhhhhhhhhhhhhhhhhhhhhhhhhhhhhhhhhhhhhhhhhhhhhh
HhhhHhhhHhhhHhhhHhhhHhhhHhhhHhhhHhhhHhhhHhhhHhhhHhhh