HHHHHHHHHHHHHHHHHHHHHHHHHHHHHHHHHHHHHHHHHHHHHHHHHH
V                                                V
V      HHHHHHHH                                  V
V                                                V
V      V                                         V
V      V                                         V
V      V                                         V
V                                                V
V                                                V
V                                                V
V                                                V
V                                                V
V                                                V
V                                                V
V                                                V
V                                                V
V                                                V
V                                                V
V                                                V
V                                                V
V                                                V
V                                                V
V                                                V
V                                                V
V                                                V
V                                                V
V                                                V
V                                                V
V                                                V
V                                                V
V                                                V
V                                                V
V                                                V
V                                                V
V                                                V
V                                                V
V                                                V
V                                                V
V                                                V
V                                                V
V                                                V
V                                                V
V                                                V
V                                                V
V                                                V
V                                                V
V                                                V
V                                                V
V                                                V
HHHHHHHHHHHHHHHHHHHHHHHHHHHHHHHHHHHHHHHHHHHHHHHHHH